111111
100001
100001
145001
144001
111111